# # # # # # # # #\
# . . . # . . . #\
# . . . # . . . #\
# . . . . . . . #\
# . . . # # . # #\
# . # # # . . . #\
# . . . # . . . #\
# . . . . . . . #\
# # # # # # # # #}
